...............................
...............................
...............................
...##...#...##...##...#...##...
...##...#...##...##...#...##...
...##...#...##...##...#...##...
...##...#...##...##...#...##...
...##...#...##@@@##...#...##...
...##...#...##@@@##...#...##...
...##...#...##...##...#...##...
...##...#...##...##...#...##...
...............................
...............................
...............................
.....###...............###.....
@@...###...............###...@@
........#.............#........
........#...##...##...#........
...##...#...#######...#...##...
...##...#...#######...#...##...
...##...#...##...##...#...##...
...##...#...##...##...#...##...
...##...#...##...##...#...##...
...##...#...##...##...#...##...
...##...#.............#...##...
...##...#.............#...##...
...##...#.............#...##...
.............####..............
.............#..#..............
.............#..#..............